...###
..#..#.####
.....##...#
##........#
#......#..#
###..###..#
#....#....#
.##..#.#.##
.#...@..##
.#######