#@########
#.#......#
#.#.####.#
#........#
##.#####.#
#...#.#..#
#........#
#.###.#..#
#.....##.#
##########